
calculated_host_listings_count_shared_rooms 1
+-------------------------------------------+
|calculated_host_listings_count_shared_rooms|
+-------------------------------------------+
|7                                          |
|15                                         |
|11                                         |
|42                                         |
|3                                          |
|30                                         |
|8                                          |
|16                                         |
|0                                          |
|5                                          |
|6                                          |
|9                                          |
|1                                          |
|10                                         |
|4                                          |
|12                                         |
|14                                         |
|2                                          |
+-------------------------------------------+

