
calculated_host_listings_count_private_rooms 63
+--------------------------------------------+
|calculated_host_listings_count_private_rooms|
+--------------------------------------------+
|7                                           |
|15                                          |
|11                                          |
|112                                         |
|73                                          |
|3                                           |
|59                                          |
|8                                           |
|0                                           |
|5                                           |
|31                                          |
|18                                          |
|27                                          |
|17                                          |
|26                                          |
|6                                           |
|48                                          |
|9                                           |
|24                                          |
|1                                           |
+--------------------------------------------+
only showing top 20 rows

